R 1120 780
NO ./textures/redbrick.xpm
SO ./textures/mossy.xpm
WE ./textures/illuminati.xpm
EA ./textures/nyan_cat0.xpm

S ./textures/barrel.xpm
F 200,200,200
C 60,60,60

1111111111111111111111111
1000000000110000000000001
1011000001110000002000001
1001000000000000000000001
1111111111110000011100001
10000000001000000111011111111
1000011100000001110000001000111111111111111
100001 100000001110000001000000000000000001
1000011100000001110000000020111111111111111
10002000000000001100000000001
10000000000000001101010010001
10000001110000011111011110N0111
10000001 1000001 101111010001
11111111 1111111 111111111111
